11111111111111111111
10000000000000000001
11110111111111110111
10000000000000000001
11110111111111110111
10000000000000000001
11111111111111111111
pacman:1,1
ghosts:1,5;5,3;5,4

11111111111111111111
10000101000010100001
10110101011010101101
10010000010000100101
11011111011111110111
10000000000000000001
11110111101111011111
10000100000001000001
10110101100101011101
10010001000100010001
11011111111111011101
10000000000000000001
11111111111111111111
pacman:1,1
ghosts:10,10;8,8;5,5