11111111111111111111
10000000000000000001
11110111111111110111
10000000000000000001
11110111111111110111
10000000000000000001
11111111111111111111
pacman:1,1
ghosts:1,5;5,3;5,4

11111111111111111111
10000101000010100001
10110101011010101101
10010000010000100101
11011111011111110111
10000000000000000001
11110111101111011111
10000100000001000001
10110101100101011101
10010001000100010001
11011111111111011101
10000000000000000001
11111111111111111111
pacman:1,1
ghosts:10,10;8,8;5,5

111111111111111111111111111111
100000000000001000000000000001
101111111111101011111111111101
100000000001100000000000000001
111111101111101110111111111101
100000101000001000001010000001
101111101011111011111010111111
100000000010000000000010000001
111101111011101111110111101111
100001000000000000000000001001
101111101110111111101111111101
100000000000000000000000000001
111111111111111111111111111111
pacman:1,1
ghosts:12,11;1,11;28,11

1111111111111111111111111111111
1000000000001010000000000000001
1010101011101010111011101111101
1000100000001010100000001000001
1011101011101010101011101011101
1010000000000000101010000000001
1010111010101010101010111011111
1000000010001000101000001010001
1011111010111111101010101010101
1000001010000000100000101000101
1011101010111010101010101111101
1000101000000010000000101000001
1011101011111111101010101010101
1000100000000000000010100000101
1010101011101111101010111010101
1010000000001000000000100000101
1010111011111011101110101010101
1000000000000000000000000000001
1111111111111111111111111111111
pacman:4,5
ghosts:21,11;13,9;29,17

11111111111111111111
10000000000010000001
11110111111011101111
10000100000000100001
10110111101111111101
10100000000000000001
10111011111101111101
10000000000000000001
11110111111011101111
10000000000010000001
11111111111111111111
pacman:1,1
ghosts:9,9;8,8;4,4
