1111111111111111111111111111111
1000100000000000001000000000001
1011101010101011111010111010101
1000000010101000000000001000001
1011111010111011101111101010101
1000100000100010000000100000001
1010101111101011101010111011101
1010001000100000000000000000001
1011101010101111101011101011101
1000000010000000100000100010001
1010101111101111101011111010111
1000100000001000100000000000001
1011101010101010101110101111101
1010001000000010101000000000001
1010111010111010101010101110101
1010000010000010000010001000001
1010111011101010111110101011101
1000100000001010000000000000001
1111111111111111111111111111111
pacman:5,12
ghosts:16,3;4,3;27,2
